11111111111111111
100P00100000C0001
10000000011110001
111100000000000C1
11000000000000101
1C000000000111011
11111100000100E01
1C00000000C110001
11111111111111111